# Pronouns

se - to him, to her
lo - him
le - to him, her
me - me
él - he
ella - she
te - you
nos - us
yo - I
usted - you
mí - me
nosotros - we
tú - you
sí - oneself
ti - you
os - you
conmigo - with me
vos - you

# Nouns

el año - year
el país - country
el tiempo - time
la parte - part
la vida - life
los años - years
el día - day
la vez - time
la persona - person
la mujer - woman
el caso - case
el hombre - man
el momento - moment
el mundo - world
la casa - house
la cosa - thing
el gobierno - government
el lugar - place
el trabajo - work
la forma - form
el estado - state
el grupo - group
el punto - point
el niño - child
la ciudad - city
el problema - problem
el sistema - system
el presidente - president
la manera - way
la historia - history
el tipo - type
los millones - millions
el partido - party
el mes - month
la noche - night
la obra - work
el equipo - team
el proceso - process
las veces - times
el cambio - change
el hijo - son
el centro - center
el servicio - service
la empresa - company
la cuenta - account
la mano - hand
el nivel - level
el proyecto - project
la gente - people
el agua - water
la hora - time
el padre - parent
el desarrollo - development
la semana - week
el lado - side
la familia - family
la situación - situation
la madre - mother
la información - information
el fin - end
el programa - program
la salud - health
el cuerpo - body
la actividad - activity
el derecho - right
el ejemplo - example
el libro - book
el medio - middle
el tema - topic
los días - days
la ley - law
el hecho - fact
la zona - zone
el nombre - name
el resultado - result
el número - number
el final - end
el sector - sector
la calle - street
el estudio - study
la puerta - door
la investigación - research
el espacio - space
la sociedad - society
la acción - action
el pueblo - town
el director - director
la realidad - reality
la voz - voice
el producto - product
el amigo - friend
el mercado - market
la cabeza - head
la población - population
la muerte - death
el minuto - minute
la tierra - land
la verdad - truth
el sentido - sense
el hermano - brother
la medida - measure
la seguridad - security
la imagen - image
la comunidad - community
el poder - power
la universidad - university
el uso - use
la razón - reason
la organización - organization
la idea - idea
la educación - education
el paso - step
el área - area
el siglo - century
el objetivo - target
el dato - data
la posibilidad - possibility
la producción - production
el joven - youth
la necesidad - need
el policía - police
la especie - species
el camino - path
el plan - plan
el arte - art
la atención - attention
el ciento - hundred
la política - policy
la decisión - decision
la cultura - culture
la luz - light
la mayoría - majority
la mañana - morning
la enfermedad - disease
la relación - relationship
el juego - game
el campo - field
la edad - age
la experiencia - experience
el riesgo - risk
la fuerza - force
la calidad - quality
los ojos - eyes
la región - region
el amor - love
las horas - hours
el movimiento - movement
la palabra - word
la guerra - war
el dinero - money
la capacidad - capacity
el autor - author
el dólar - dollar
el precio - price
el acuerdo - agreement
la cara - face
el control - control
el modelo - model
el frente - front
la tarde - afternoon
la autoridad - authority
la película - film
la línea - line
la red - network
las condiciones - conditions
la falta - fault
el peso - weight
el modo - mode
la música - music
el ministro - minister
el fondo - background
la base - base
la orden - order
la clase - class
la presencia - presence
la función - function
la mesa - table
el actor - actor
la respuesta - answer
la ocasión - occasion
el principio - principle
el paciente - patient
el efecto - effect
la diferencia - difference
el señor - mister
el papel - paper
la serie - series
las manos - hands
la capital - capital
la fuente - source
la duda - doubt
el aspecto - aspect
el miembro - member
la compañía - company
el jefe - boss
el jugador - player
la vista - view
la cantidad - quantity
la dirección - address
el valor - value
el resto - rest
el silencio - silence
el / la ex - ex
el aire - air
el metro - metro
el teatro - theater
el apoyo - support
la mirada - look
la tecnología - technology
el personaje - character
la energía - energy
el viaje - trip
el futuro - future
el acto - event
el / la artista - artist
la época - period
el ministerio - ministry
el sueño - dream
el euro - euro
la causa - cause
el sitio - site
la figura - figure
el consejo - advice
el cargo - position
el profesor - professor
la propuesta - proposal
el cine - cinema
la escuela - school
el ojo - eye
el público - public
el objeto - object
los recursos - resources
el tratamiento - treatment
el compañero - colleague
la libertad - freedom
la participación - participation
el asunto - subject
el interés - interest
la unidad - unit
el banco - bank
la vuelta - turn
la posición - position
la carrera - career
las palabras - words
la planta - plant
la práctica - practice
el esfuerzo - effort
la comunicación - communication
la comisión - commission
la economía - economy
el ser - being
el análisis - analysis
el pie - footer
las relaciones - relations
el conocimiento - knowledge
la crisis - crisis
el premio - award
el encuentro - meeting
el conjunto - set
la consecuencia - consequence
el suelo - soil
la década - decade
el texto - text
el miedo - fear
el / la estudiante - student
el título - title
el origen - source
el médico - doctor
la formación - training
la fecha - date
la boca - mouth
el sol - sun
el éxito - success
la entrada - entry
la sala - room
el crecimiento - growth
la reunión - meeting
el animal - animal
el informe - report
el hospital - hospital
la importancia - importance
el negocio - business
el mar - sea
el consumo - consumption
el artículo - article
la prensa - press
la carta - letter
el departamento - department
el material - material
la estrategia - strategy
la construcción - construction
la televisión - television
el color - color
la estructura - structure
el general - general
el cabo - cape

# Adjectives

nuevo - new
grande - big
bueno - good
último - last
mayor - greater
nacional - national
social - social
mejor - better
propio - own
importante - important
público - public
alto - high
político - political
pequeño - small
único - unique
largo - long
humano - human
económico - economic
posible - possible
general - general
internacional - international
diferente - different
solo - only
español - Spanish
principal - main
necesario - required
próximo - next
distinto - different
claro - light
siguiente - following
malo - bad
anterior - previous
especial - special
natural - natural
cultural - cultural
bajo - low
actual - current
blanco - white
fuerte - strong
difícil - difficult
mundial - world-wide
menor - lesser
viejo - old
real - real
local - local
negro - black
europeo - European
diverso - various
libre - free
seguro - safe
común - common
privado - private
central - central
popular - popular
dicho - such
físico - physical
superior - top
joven - young
personal - personal
capaz - capable
antiguo - old
histórico - historical
cierto - certain
técnico - technical
presente - present
oficial - official
mexicano - Mexican
fácil - easy
militar - military
contrario - contrary
civil - civil
verdadero - true
lleno - full
suficiente - enough
rápido - fast
científico - scientific
directo - direct
completo - complete
interno - internal
fundamental - fundamental
comercial - commercial
familiar - familiar
amplio - extensive
educativo - educational
vivo - live, alive
similar - similar
rojo - red
financiero - financial
medio - medium
enorme - huge
total - total
profesional - professional
adecuado - suitable
médico - doctor
grave - serious
tradicional - traditional
electoral - electoral
básico - basic
igual - same
duro - hard
profundo - deep
final - last
municipal - municipal
inmediato - immediate
junto - together
argentino - Argentinean
peor - worse
francés - French
corto - short
oscuro - dark
estadounidense - American
cercano - near
regional - regional
feliz - happy
positivo - positive
máximo - maximum
serio - serious
laboral - labor
imposible - impossible
simple - simple
pobre - poor
reciente - recent
extraño - strange
ambiental - environmental
específico - specific
normal - normal
determinado - determined
moderno - modern
urbano - urban
mínimo - minimum
musical - musical
deportivo - sporty
federal - federal
frío - cold
legal - legal
verde - green
interesante - interesting
artístico - artistic
judicial - judicial
particular - particular
colombiano - Colombian
previo - previous
cubano - Cuban
pleno - full
eléctrico - electric
tecnológico - technology
abierto - open
global - global
infantil - childish
absoluto - absolute
definitivo - definitive
complejo - complex
estatal - statewide
rico - rich
raro - rare
significativo - significant
sencillo - simple
perfecto - perfect
permanente - permanent
religioso - religious
activo - active
famoso - famous
numeroso - numerous
rural - rural
tranquilo - quiet
extranjero - foreign
democrático - democratic
azul - blue
femenino - female
escaso - scarce
intenso - intense
puro - pure
unido - joined
universitario - academic
original - original
exterior - outside
seco - dry
digital - digital
alemán - German
literario - literary
independiente - independent
armado - armed
sanitario - sanitary
electrónico - electronic
indígena - indigenous
concreto - concrete
fiscal - fiscal
clásico - classic
evidente - clear
individual - individual
colectivo - collective
negativo - negative
productivo - productive
doble - double
anual - annual
efectivo - effective
habitual - usual
inicial - initial
débil - weak

# Verbs

ser - be
estar - be
tener - have
hacer - make
poder - be able to, can
decir - say
haber - have
ir - go
dar - give
ver - see
saber - know
pasar - pass by
deber - must
querer - want
llegar - arrive
dejar - leave
llevar - take
encontrar - find
seguir - follow
poner - put
quedar - stay
parecer - seem
hablar - speak
pensar - think
volver - back to
conocer - know
salir - exit
realizar - make
tomar - take
tratar - try
contar - count
llamar - call
venir - come
mirar - see
presentar - present
permitir - allow
esperar - wait
sentir - feel
vivir - live
buscar - search
creer - believe
crear - create
perder - lose
existir - exist
considerar - consider
abrir - open
trabajar - work
recibir - receive
mantener - maintain
explicar - explain
lograr - achieve
empezar - start
recordar - remember
comenzar - start
pedir - ask for
preguntar - ask
producir - produce
convertir - convert
entrar - enter
mostrar - show
señalar - point out
escribir - write
utilizar - use
entender - understand
terminar - finish
ganar - win
incluir - include
morir - die
asegurar - secure
ocurrir - occur
ofrecer - offer
jugar - play
gustar - like
escuchar - listen to
sentar - sit
cambiar - change
aparecer - appear
acabar - end
decidir - decide
resultar - result
caer - fall
desarrollar - develop
necesitar - need
sacar - take out
establecer - establish
conseguir - get
indicar - indicate
formar - form
reconocer - recognize
dirigir - address
servir - serve
alcanzar - reach
intentar - try
cumplir - meet
leer - read
obtener - get
ayudar - help
usar - use
observar - see
responder - answer
afirmar - claim
evitar - avoid
suponer - assume
afectar - affect
generar - generate
continuar - continue
cerrar - close
pagar - pay
acercar - bring over
levantar - raise
participar - participate
representar - represent
tocar - touch
informar - inform
destacar - highlight
iniciar - start
dedicar - dedicate
oír - hear
acompañar - accompany
referir - refer to
sufrir - suffer
nacer - birth
comer - eat
bajar - download
suceder - succeed
dormir - sleep
preparar - prepare
agregar - add
correr - run
subir - go up
publicar - publish
traer - bring
anunciar - announce
descubrir - discover
construir - build
detener - stop
aceptar - accept
meter - tuck in
ocupar - occupy
demostrar - show
proponer - propose
estudiar - study
comprar - buy
expresar - express
olvidar - forget
aumentar - increase
definir - define
regresar - return
añadir - add
mover - move
entregar - deliver
sostener - hold
reducir - reduce
aprender - learn
provocar - provoke
mejorar - improve
unir - join
constituir - constitute
compartir - share
enfrentar - confront
imaginar - imagine
crecer - grow
comprender - understand
apoyar - support
comentar - comment
vender - sell
faltar - skip
aplicar - apply
colocar - place
cubrir - cover
repetir - repeat
disponer - arrange
obligar - force
celebrar - celebrate
echar - cast out of
relacionar - link
marcar - mark
desear - wish
significar - mean
caminar - walk
superar - go beyond
organizar - organize
registrar - register
andar - walk
identificar - identify
elegir - choose
abandonar - leave
soler - be used to
plantear - raise
ubicar - locate
requerir - request
partir - start
reunir - gather
actuar - act
lanzar - launch
importar - import
analizar - analyze
mencionar - mention
sumar - add
pretender - pretend
enviar - send
declarar - declare
manifestar - manifest
atender - attend
basar - base
recuperar - retrieve
aprovechar - take advantage of
asumir - assume
desaparecer - disappear
funcionar - work
permanecer - stay
preocupar - concern
preferir - prefer
confirmar - confirm
advertir - warn
imponer - impose
integrar - integrate
recoger - pick up
parar - stop
proteger - protect
depender - depend
negar - deny
resolver - solve
surgir - arise
corresponder - correspond
determinar - determine
concluir - conclude
visitar - visit
exigir - demand
contener - contain
aprobar - approve
romper - break
viajar - travel
quitar - remove
interesar - interest
defender - defend
avanzar - advance
prever - foresee
implicar - involve
apuntar - point out
invitar - invite
causar - cause
vestir - dress
controlar - check
adquirir - purchase
incorporar - incorporate
guardar - save
insistir - insist
conducir - drive
acordar - agree
contestar - answer
tirar - throw away
despertar - wake up
reír - laugh
sorprender - surprise
llorar - cry
situar - locate
garantizar - guarantee
separar - separate
impedir - prevent
gritar - shout
costar - cost
cruzar - cross
disfrutar - enjoy
cantar - sing
citar - quote
sonreír - smile
extender - extend
poseer - own
contribuir - contribute
exponer - exhibit
instalar - install
notar - note
sonar - sound
convencer - convince
mandar - send
asociar - link
aportar - provide
acudir - go to
asistir - attend
firmar - sign
pertenecer - belong to
solicitar - request
enseñar - show
cortar - cut
recorrer - tour
fijar - post
promover - promote
describir - describe
revelar - reveal
retirar - withdraw
contemplar - see
elaborar - elaborate
ordenar - order
hallar - find
reflejar - reflect
limitar - limit
rodear - go around
transformar - transform
interpretar - interpret
llenar - fill out
consistir - consist of
cuidar - care
someter - submit
avisar - warn
emplear - use

# Adverbs

no - not
    más - more
apenas - hardly
también - also
ya - already
muy - very
básicamente - basically
solo - only
después - later
ahora - now
así - thus
bien - well
siempre - always
antes - before
tan - so
cómo - how
sí - yes
hoy - today
entonces - then
luego - then
además - in addition
nunca - never
casi - almost
poco - sparsely
aquí - here
menos - least
tanto - such
sin embargo - however
mucho - a lot
aún - still
dentro - within
ayer - yesterday
allí - there
incluso - inclusive
ahí - there
ruidosamente - loudly
todavía - still
hasta - even
tampoco - nor
cerca - near
allá - there
apenas - barely
a lo mejor - perhaps
cuidadosamente - carefully
pronto - soon
normalmente - normally
fuera - out
atrás - behind
encima - above
tarde - afternoon
finalmente - finally
especialmente - especially
tal vez - maybe
lejos - far
demasiado - too
quizá - maybe
mal - badly
perfectamente - perfectly
bastante - quite a lot
diariamente - daily
adelante - forward
detrás - back
igual - likewise
ni siquiera - not even
primero - first
actualmente - currently
así como - as well as
precisamente - precisely
arriba - up
realmente - actually
jamás - never
quizás - maybe
recién - just
asimismo - also
no obstante - however
difícilmente - with difficulty
alrededor - around
solamente - only
aun - even
por supuesto - of course
delante - in front
abajo - below
para nada - not at all
fácilmente - easily
simplemente - simply
directamente - directly
lentamente - slowly
debajo - under
por tanto - therefore
principalmente - mainly
por lo tanto - therefore
totalmente - totally
a menudo - often
por lo menos - at least
acá - here
probablemente - probably
prácticamente - practically
seguramente - surely
frecuentemente - frequently
aproximadamente - approximately
completamente - completely
posteriormente - later
nuevamente - again
por fin - finally
igualmente - equally
jamás - never
acaso - perhaps
justo - just
recientemente - recently
por favor - kindly
rápidamente - quickly
únicamente - only
afuera - outside
respectivamente - respectively
inmediatamente - immediately
exactamente - exactly
claramente - clearly
generalmente - generally
perfectamente - perfectly
enseguida - right away
temprano - early
adentro - inside

# Prepositions

de - from
en - at, in, on
a - to
con - with
por - by
para - for
sobre - about
entre - between
sin - without
desde - from
hasta - to, until
durante - during
hacia - to
ante - before
contra - against
según - according to
tras - after
bajo - under
a través de - through
a partir de - as of
frente a - in front of
además de - in addition to
a pesar de - in spite of
mediante - through
junto a - together with
debido a - due to
gracias a - thanks to
pese a - despite
de acuerdo con - in accordance with
en cuanto a - in regard to
junto con - together with
acerca de - about
respecto a - with respect to
en torno a - around
en lugar de - instead of
de acuerdo a - according to

# Conjunctions

y - and
e - and
ni…ni - neither…nor
o - or
u - or
o bien…o bien - either…or
pero - but
mas - but
aunque - although
es decir - that is
porque - because
pues - since
si - if
como - as

# Interjections

guay - cool
vale - okey
guau - wow
bravo - good job
claro - of course
huy - oops
ojalá - I hope so

