gente - люди
persona - человек
hombre - мужчина
marido - муж
mujer - женщина, жена
niño - ребенок
muchacho - мальчик
muchacha - девочка
amigo - друг
invitado - гость

familia - семья
padres - родители
padre - отец
madre - мать
hijo - сын
hija - дочь
abuelo - дед
abuela - бабушка
suegro - тесть, свекор
suegra - теща, свекровь
tío - дядя
tía - тетя
hermano - брат
hermana - сестра
primo - двоюродный брат
prima - двоюродный сестра

trabajo - работа
maestro - учитель
conductor - водитель
obrero - рабочий
ingeniero - инженер
doctor - врач
enfermera - медсестра
vendedor - продавец
contador - бухгалтер
pintor - художник
estudiante - студент

país - страна
España - Испания

animal - животное
gato - кошка
perro - собака
pájaro - птица

ciudad - город
escuela - школа
teatro - театр
calle - улица
plaza - площадь
lugar - место
casa - дом
iglesia - церковь
río - река
café - кафе, кофе
hotel - гостиница
jardín - сад
parque - парк
banco - банк
parada - остановка
cine - кинотеатр
puente - мост
intersección - перекрёсток
bosque - лес
hospital - больница
mercado - рынок
policía - полиция
oficina de correos - почта
estación - станция, вокзал
centro - центр
tienda - магазин
montaña - гора

apartamento - квартира
cocina - кухня
balcón - балкон
cuarto de baño - ванная
ducha - душ
inodoro - туалет
suelo - пол
techo - потолок
piso - этаж
pasillo - коридор
dormitorio - спальня
sala de estar - зал
puerta - дверь
ventana - окно
llave - ключ
cama - кровать
almohada - подушка
mesa - стол
silla - стул
sillón - кресло
nevera - холодильник
sofá - диван
espejo - зеркало

comida - еда
pan - хлеб
mantequilla - масло
queso - сыр
salchichón - колбаса
aceite - растительное масло
pimienta - горький перец
sal - соль
baya - ягода
miel - мёд
mermelada - варенье
seta - гриб
cebolla - лук репчатый, репчатый лук
banana - банан
zanahoria - морковь
pera - груша
remolacha - свекла
fruta - фрукты
melón - дыня
sandía - арбуз
pastel - пирожное, пирожок
tarta - торт
chocolate - шоколад
carne - мясо
patatas - картофель
ensalada - салат
tomate - помидор
pepino - огурец
col - капуста
papilla - каша
sopa - суп
bocadillo - бутерброд
soda - газировка
agua - вода
té - чай
leche - молоко
jugo - сок
manzana - яблоко
uvas - виноград
naranja - апельсин
piña - ананас
albaricoque - абрикос
azúcar - сахар
arroz - рис
fideos - лапша
res - говядина
cerdo - свинина
pollo - курица
chuleta - котлета
limón - лимон
guisante - горох
bollo - булочка
pescado - рыба
caramelo - конфета
helado - мороженое
nuez - орех
huevo - яйцо
melocotón - персик

taza - чашка
vaso - стакан
plato - тарелка
cuchara - ложка
tenedor - вилка
cuchillo - нож
platillo - блюдце
botella - бутылка
servilleta - салфетка

desayuno - завтрак
almuerzo - обед
cena - ужин

avión - самолет
coche - автомобиль
tranvía - трамвай
autobús - автобус
tren - поезд
bicicleta - велосипед

tiempo - время, погода
año - год
semana - неделя
hora - час
minuto - минута
ayer - вчера
hoy - сегодня
mañana - завтра, утро
fiesta - праздник, вечеринка
vez - раз

día - день
tarde - вечер
noche - ночь

lunes - понедельник
martes - вторник
miércoles - среда
jueves - четверг
viernes - пятница
sábado - суббота
domingo - воскресенье

mes - месяц
enero - январь
febrero - февраль
marzo - март
abril - апрель
mayo - май
junio - июнь
julio - июль
agosto - август
septiembre - сентябрь
octubre - октябрь
noviembre - ноябрь
diciembre - декабрь

primavera - весна
verano - лето
otoño - осень
invierno - зима

nombre - имя, фамилия
dirección - адрес
número - номер
cumpleaños - день рождения
casado - женатый
casada - замужняя

cosa - вещь
pluma - ручка
libro - книга
ajedrez - шахматы
teléfono - телефон
reloj - часы
peine - расчёска
televisor - телевизор
plancha - утюг
jabón - мыло
radio - радио
bolsa - сумка
mapa - карта, открытка
maleta - чемодан
regalo - подарок
cámara - фотоаппарат, видеокамера
ordenador - компьютер
película - фильм, плёнка
flor - цветок
florero - ваза
cuadro - картина
pañuelo - носовой платок
bola - мяч
globo - воздушный шар, воздушный шарик
juguete - игрушка
cuenta - счёт
sobre - конверт
papel - бумага
periódico - газета
carta - письмо
billete - билет

ropa - одежда
zapatos - обувь
abrigo - пальто
vestido - платье
camisa - рубашка
falda - юбка
guante - перчатка
sombrero - шляпа
chaqueta - пиджак, куртка
bufanda - шарф
calcetín - носок
suéter - свитер
camiseta - футболка
corbata - галстук
pantalones - брюки

mano - рука
pie - нога
cabeza - голова
ojo - глаз
lengua - язык
nariz - нос
boca - рот
oreja - ухо

qué - что, какой
cual - какой
quién - кто
dónde - где
a dónde - куда
de dónde - откуда
cómo - как
por qué - почему
cuándo - когда

yo - я
tú - ты
él - он
ella - она
usted - Вы
ustedes - Вы
nosotros - мы
vosotros - вы
ellos - они
ellas - они

mi - мой
tu - твой
su - его, ее, их, Ваш
nuestro - наш
vuestro - ваш

#de - из, передает род. падеж
a - к
sobre - на
debajo de - под
detrás de - позади
con - с
sin - без
antes de - до, прежде
después de - после
delante de - перед
entre - между
en - в
cerca de - возле
para - для

uno - один
dos - два
tres - три
cuatro - четыре
cinco - пять
seis - шесть
siete - семь
ocho - восемь
nueve - девять
diez - десять
once - одиннадцать
doce - двенадцать
trece - тринадцать
catorce - четырнадцать
quince - пятнадцать
dieciséis - шестнадцать
diecisiete - семнадцать
dieciocho - восемнадцать
diecinueve - девятнадцать
veinte - двадцать
treinta - тридцать
cuarenta - сорок
cincuenta - пятьдесят
sesenta - шестьдесят
setenta - семьдесят
ochenta - восемьдесят
noventa - девяносто
ciento - сто
mil - тысяча

viejo- старый
joven - молодой
nuevo - новый
grande - большой
pequeño - маленький
hambriento - голодный
bueno - хороший
malo - плохой
bien - хорошо
mal - плохо
temprano - ранний
tarde - поздний
pasado - последний, прошлый
próximo - следующий
libre - свободный
caliente - тёплый, горячий
frío - холодный
alto - высокий
bajo - низкий
largo - длинный, долгий
corto - короткий
fácil - лёгкий, несложный
difícil - тяжёлый, трудный
ligero - легкий, по весу
pesado - тяжелый, по весу
oscuro - тёмный
claro - светлый
caro - дорогой
barato - дешёвый
a la izquierda - слева
a la derecha - справа
correcto - правильный
rápido - быстрый
despacio - медленный
suave - мягкий
duro - твёрдый
bonito - красивый
atento - внимательный
triste - печальный
alegre - радостный
feliz - счастливый
listo - готовый
enojado - сердитый
principal - основной, главный

negro - чёрный
azul - голубой, синий
marrón - коричневый
verde - зелёный
gris - серый
rojo - красный
blanco - белый
amarillo - жёлтый

sí - да
no - нет, не
este - этот
ese - тот
aquel - тот, дальше чем ese
que - что
aquí - здесь
allí - там
acá- сюда
allá - туда
ahora - сейчас, теперь
ya - уже
todavía - еще
mucho,mucha,muchos,muchas - много
poco,poca,pocos,pocas - мало
muy - очень
cada - каждый
todos - все
todo - всё
tan - так
también - так же, тоже

y - и
o - или
pero - но
porque - потому что, так как

ser - быть, являться
estar - быть, находиться, стоять
tener - иметь
poder - мочь
deber - должен
vivir - жить
permanecer - оставаться, останавливаться
venir - приходить, приезжать
ir - идти, ехать
ver - видеть
sentar - сидеть
decir - сказать
hablar - разговаривать
trabajar - работать
romper - ломать
hacer - делать
enviar - посылать
comprar - покупать
nadar - плавать
dormir - спать
despertar - будить
lavar - мыть, cтирать
probar - пробовать
encontrar - находить
traer - приносить, привозить
celebrar - праздновать
sonreír - улыбаться
llorar - плакать
costar - стоить
aprender - учиться
enseñar - обучать
escribir - писать
cambiar - менять
caer - падать
escuchar - слушать
mostrar - показывать
ganar - побеждать
pensar - думать
cerrar - закрывать
abrir - открывать
saber - знать
conocer - быть знакомым
cantar - петь
bailar - танцевать
preguntar - спрашивать
contestar - отвечать
recoger - собирать
amar - любить
dibujar - рисовать
elegir - выбирать
querer - хотеть
comer - кушать
beber - пить
dar - давать
hornear - печь
cocinar - готовить
cortar - резать
tomar - брать
esperar - ждать
leer - читать
jugar - играть
fumar - курить
crear - создавать
luchar - бороться, драться

gracias - спасибо
perdón - извини, извините
por favor - пожалуйста, прошу
de nada - пожалуйста, не за что
qué lástima - жаль
hasta la vista - до свидания

canción - песня
música - музыка
tamaño - размер
dinero - деньги
felicidad - счастье
suerte - удача
broma - шутка
sorpresa - сюрприз
problema - проблема

lluvia - дождь
viento - ветер
nieve - снег
cielo - небо